....................................................................................................
.##################################################################################################.
.#.....#.....#######.#......##.....####......................................................#.##.#.
.#.....#####.#.#...#.#.##.#####.##.#..###....................................................#....#.
.#..@............!.#.#.#...#..#.#..##...#...#####...#...#####.#...#...#.....#...#..#....#....#.!.##.
.#.....#####.###...#.#.#.!.#.##.##.##.#.....#...#..###..#...#.##.##..###...###..#..#...###...#...##.
.#.....#..##.#.#####.#.#...#.##.##.#..###...#...#..#.#..#......###...#.#...#.#..#.##...#.#...##.###.
.###.####.......#....#.#####.#...#.##..#....#...#..#.#..#.......#....#.#...#.#..###....#.#......###.
.#...#..#.#####.#.####.......#####.#..###...#...#.#####.#......###..#####.##.##.#.##..#####..##..##.
.#.#.#.##.#...#.#.##.#.##.#.##...#.##.#.....#...#.#...#.#...#.##.##.#...#.#...#.#..#..#...#..##.###.
.#.#.#.##.#.!...........#.#....#........#...#...#.#...#.#####.#...#.#...#.#...#.#..#..#...#..#..###.
.#.#.#.#..#...#.###.###.#.##.#####.######....................................................##..##.
.###.#.##.#####.#.###.###..#.#.....#.#..#....................................................#..###.
.#..............#.........##.##.####.#.########################################################.###.
.#.#.############.#####.###...#.#................................................................##.
.#.#.#..........#.#...###.###.#.##.#.#####.#####.#########.###.####.#.##########################.##.
.#.#.#.########.#.#.#.....#.#.####.###...#.....#.##......###.#....###.#..............#.........#.##.
.#.#.#....#...#.#.###.###.#.#........##.##.###.#....##.#.......##.#.#.#.#.#.##.##.!.##.##.#.##.#.##.
.#.#.##.#.#.###.#.#.#.#.#.#.#.######.#.....#...#.##.########.####.#.#.#.#####...#...#...#.######..#.
.#.#.####.#.#...#.....#...#...#....#...#######.#.####.##.##...#...#.#.#.....##.####.##.##........##.
.#........#.#.#########.#.##.###.#.#.#.#.##.##.#...#......###.#.#.#.#.#######....##....#..##.##.###.
.###.######...#...#.....#..###.###.#.#.#.......#.#.##.#.#..#..###.#.#.#.......##..##########.#..###.
.###.#...######.#.####.###.........#.#.#.#########....#########.#.#.#.###########..#.....#.#.#.####.
.#.....!.#......#....#.#.#.#.#.#.###.#.#.#.........##.#...........#.#...........##.#####...#.#...##.
.#.###...########.##.#.#.#.########..#...#.##.##.#.#####.#.#.##.###.###.####.##.##.......###.######.
.#.#.###.#.#.......#.#.#.#.##.#.#.#.##.###.#...#.#..#.#..#.#.##.........#.....#..###.#.#.#.......##.
.#.#.#.#.#.#.#####.###.#.#........#.##.#...##.##.##.....##.#..#.##########.#.###.##..#.####.!.##..#.
.#.#.......#.#.#.#.#.#.#.##.####.##.#..#.#.#......#.#.#.####.#####.......###.###..######......##.##.
.#.####.#.##...#...#.#.#.##...##.#..##.######.###########.....##...##.##..##...##........##.#.#..##.
.#......#....#######...#.#..#..####.....##.##.##.....#.#..#.###..###...##..###..######.###..#.##.##.
.#############.....#####.##.#####.#.###.....#..###.#.....##.##..##.#######..###.#.#.##.######..#.##.
.##............###........#.......#.#.#.###.##..#..#####.####..##..#....###............##..##.##.##.
.##.#.#.###.##.#.###.####.#.#######...#..##.###.##.....#......###.##.##.#.##.#####.###.#....#.#####.
.#..#.###.#.####.#.#.#.##.#.#.....#.!.#.##....#..####.##.##.#.##.....##....#........####.##.#....##.
.##.#.....................#.#####.#...#.###.#.##...##.....#.#..#.#.#..##.#.#.######......#..##.#.##.
.##.###################.###.....#.#####...#.#..###..#####.#.##.#.####.##.#.#.....##########.##.#.##.
.#......................#.#.###.#.##.##.#.#.#.##.##..#.#..#.#.....##..#..#.#.#.#...............#..#.
.########################.#.#.###.......#.#.#.....##...##.#######..#######.#.#################.#.##.
.#.....#..........................#.##.##.#.###.#..#.!.##.......##.......#...#.................#.##.
.#.#####.#################.####.#.#######.#...#.#.##....###.#.######.#####.#.##.#####.########.#.##.
.#.#.....#........#.....#..#....#.#.#.....##.##....####...###..#.#.#.#.....#..#.#............#.#.##.
.#.##.####.########.##.##.###.###.#...######..#.##.#..###...##.....#########.##.#.###.####.#.#...##.
.#.##.####........####.##.#...#...##.###.#.#.##.##.#.##.###..#####..#.....#..#..#.#.####.#####.#..#.
.#.##......######..#......#.###.######...#.#.##..#.......##.....#########...###.#..............#.##.
.#.#..######....#.##.######.#...#....#.#.#.#..##.#####.#.##.#.#....#......#.....#.##############.##.
.#.##.#......##.#.##.##.....#.###.##...#...##..#...#.#.#..#.#.##.###.##.#.###.###..............#.##.
.#..#.#########.#.#..#..!.#.#.#......#.#.#.##.####.#.#.#.##.######.####.###.#.#.####.#########.#.##.
.##.#.....#.#...####.##...#.#...####.#.#.#..#.#..#...#.#.##.....#..#.#....#.....#.#...#......#.#.##.
.##.#####.#.#####..#.######.######...#.#.#.##.##.#.#...#..#.###.#.##.#.##.#.###.#.#.#.#.####.#.#.##.
.##.#.....#...#.#.##.#......#....#.#.#...#..#..#.#.###.####.#####.#..#.#..#.#.#.#.#.#...#..#.#.#.##.
.##.##.#.##.#.#.#....#.##.###.!.####.#.#.##.##.#.....#.#..#.#...#.##.#.##.#.#.#.#.#.###.#.##.#.#.##.
.##..#.######.#.######.####.#...#....#.#.##..#.##.##.#...##.#.!......#..#.#.....#...#.#.#....#.#.##.
.##.##........#........#....###.##.#...#.#..##.#####.#.#.#..#...#.##.#.##.#.#.#.#.#.#...######.#.##.
.##.#..########.######.#.##...#..#.#.###.#####.....#.###.##.#####.##.#.#..#.#.#.#.#.#.#........#.##.
.##.##..........#...#..#.####.#.##.#..#........#.#.###....#.###.#..#.#.##.#.###.#.#.############..#.
.##.##.#######.####.#.##.#.##.#.#..#.##.##.#.#.###.#...#.##.......##..............#...#...........#.
.##..###.....#.#....#.#..#....#.##.#.#...#.#.#...#.#.###..#.###.#.##########.##.#####.#.###########.
.##.##.##.##.#.#.####.##.####.#.##.#.#.!.#.#.###.#...#...########.....#.##.#######....#..........##.
.##..#..#.#..#.#......#..#.##.#....#.#...#.#.#...#.#.#.#.#...#.##.#.###....#.......##.##########.##.
.##.##.##.#.##.######.##.#.#..#.##.#.#####.#.#.#.#.#.#.#.#.#......###...####.#####.##.##..........#.
.##..#....#.#......##.#....##.#.##.#.#...#.#.###.#####.#...#.#######..#.#....#..##.......###.######.
.########.#.##.#.#..#.#.##.#..#.#..#.#.!.#.#.........#.#.#.#.........##.#.#####..#########........#.
.#........#....####.#.#######.#.##.#.....#.#.#######.#.#.#...####.####........##...........########.
.##.#.############..#..#......#.##.#.##.##.###...#...#.#.###.#.##.#....##.!.#..#############......#.
.##.###..........##.##.#.######..#.######....#.#.#.#.#.#........#.#.##.##...##....#..........######.
.##.#...########..###..#..#.#.#.##.....#####.#.#.###...####.###...#.##..##.###.####.###########...#.
.##.##.###.....##..##.##.##.#.#.##.###...#.#.#.#...#.###....#.###.#.######.#.#.#....#...........#.#.
.##..#.##..###.###.####.....#.#.....#..#...#.#.##.##..##.#.##.#...#.#......#.#.#.####.###########.#.
.##.##..##.#.###.#...##.#.#.#.#.###.#.######.#..#..#.##..#.#....###.#.######.#.#.#....#.........#.#.
.##.###.#..........#..#.#####.###.#.....#....#.###....######.##.##..#.#........#.######.#######...#.
.#..#.#.##.#.#.######.#...#.........#.!.#.##.....###.##..........#.##.#.###########...#.#.#.....###.
.##.....#..#.#...##.#.#.#.####.#.####...#####.##.#.#..##.##.####.#.#..#.#...........!.#.#.###.#.#.#.
.##.###.##.#####....#.#.#.##.#####.######...####.#.#.######.#..#.#.#.####.###.###.#...#.#.....#.#.#.
.##...#.##.....#.####.#.#...........##.#..#....#...#.#......#.##.#.#........###.#.#############...#.
.##.#.#..##.!.##.##.#.#.#############....#####.###.#.######.#..###.####.###.....#...............#.#.
.##.#.##.#....##.#..#.#...............#.##...#.#.#.......##.#.##...##.#.#.#.###.########.########.#.
.##.####.######..##.#.##############.##.#..#.#.#.##.#.##.#..#....#....#.#.#...#.......#.........#.#.
.##.#.#....#.##.##..#.........#......#..#.##.#.#..#.####.##.#########.###.#########.######.######.#.
.##.#.##.#......#..##.##.#.#########.##.#.####.#.##....#.##.#.##....#.#...#..........#.........#..#.
.##.#..#.####.###.##..#..#..#...##...##.#..#...#....####..#......##.#.#.###.#.################.####.
.##.##.####.###.#.##.###.####.###..#..#.#.##.######.##.#.##########.#.#.#...###.#.#...............#.
.##.#..............#.#....#...##..##.##.#..#.#..##..#..#.#............###.!.##....#.########.######.
.##.###.#.####.###.#.######.!.#..##..#..##.#.##..##.##.########.#.###.#.#....#.####.#.#..........##.
.##..##.###.##.###.#............##..###..#.#.###..#..#.##...#.#.###.#.#.##.###.##...#.#.#.#.##.#.##.
.###...............#.############..##...##.#...#.###....###.#.###.#.#.#.##.....#..###.#.#####..#.##.
.##..#.##.##.##.##.#.#............##..#.#..###.#..#####.#.#.###.#.#.###....###.##.##..#.#...####.##.
.##.###########.####.#########.#####.##.##...#.##..##...#.#..........###.#.#.#..#..#.##.#.!......##.
.#.......................................###.#..##.#..#.#.########.#.#.#.#.#.#.###.#....#...##.####.
.#######################################...#.##.##.####.#.......##.#.#.#.#.#.#...#.######.####....#.
.#######################################.#.#..#.........#.###.#.#..#...#.#.#.#.###.#......#....#.##.
.##.####.###.#.....#....#.###.#..###..##.#.##.######.##.#...#.###.####.#.#.#.#..#..#.##############.
.##.####.###.#.###.#.####.###.#.#.#.#.##.#......#.#...#####.#.###.#.##.#.#.#.#.##.##.#........#.###.
.##.####..#..#.#####.####.###.#.##.##.##.###.##.#.#.!.#...#.#.#...#....#.#.#.#.##.#..#.#.##.#....##.
.##.#####...##.#####...##.###.#.#####.##.#.#.##.......#.#...#.#.!.#.##.#.#.#.#....#.##.###..####..#.
.##.######.###.#####.####.###.#.#####.##.#.#.######.#...##.##.#...#.##.#.#.#.#.##.#..#.....##....##.
.##.######.###.###.#.####..#..#.#####.##.#.#......#.#########.##.##..#.#.#...#.#..#.##.######.##.##.
.##....###.###.....#....##...##.#####.##.#...####.#...........##.###.#.###.###.##.............#...#.
.#######################################...###....###.###.###..#.....#.....#....#.#############...#.
.###############################################################################################*##.
....................................................................................................