##################################################################################################
#.....#.....#######.#......##.....####......................................................#.##.#
#.....#####.#.#...#.#.##.#####.##.#..###....................................................#....#
#..@............!.#.#.#...#..#.#..##...#...#####...#...#####.#...#...#.....#...#..#....#....#.!.##
#.....#####.###...#.#.#.!.#.##.##.##.#.....#...#..###..#...#.##.##..###...###..#..#...###...#...##
#.....#..##.#.#####.#.#...#.##.##.#..###...#...#..#.#..#......###...#.#...#.#..#.##...#.#...##.###
###.####.......#....#.#####.#...#.##..#....#...#..#.#..#.......#....#.#...#.#..###....#.#......###
#...#..#.#####.#.####.......#####.#..###...#...#.#####.#......###..#####.##.##.#.##..#####..##..##
#.#.#.##.#...#.#.##.#.##.#.##...#.##.#.....#...#.#...#.#...#.##.##.#...#.#...#.#..#..#...#..##.###
#.#.#.##.#.!...........#.#....#........#...#...#.#...#.#####.#...#.#...#.#...#.#..#..#...#..#..###
#.#.#.#..#...#.###.###.#.##.#####.######....................................................##..##
###.#.##.#####.#.###.###..#.#.....#.#..#....................................................#..###
#..............#.........##.##.####.#.########################################################.###
#.#.############.#####.###...#.#................................................................##
#.#.#..........#.#...###.###.#.##.#.#####.#####.#########.###.####.#.##########################.##
#.#.#.########.#.#.#.....#.#.####.###...#.....#.##......###.#....###.#..............#.........#.##
#.#.#....#...#.#.###.###.#.#........##.##.###.#....##.#.......##.#.#.#.#.#.##.##.!.##.##.#.##.#.##
#.#.##.#.#.###.#.#.#.#.#.#.#.######.#.....#...#.##.########.####.#.#.#.#####...#...#...#.######..#
#.#.####.#.#...#.....#...#...#....#...#######.#.####.##.##...#...#.#.#.....##.####.##.##........##
#........#.#.#########.#.##.###.#.#.#.#.##.##.#...#......###.#.#.#.#.#######....##....#..##.##.###
###.######...#...#.....#..###.###.#.#.#.......#.#.##.#.#..#..###.#.#.#.......##..##########.#..###
###.#...######.#.####.###.........#.#.#.#########....#########.#.#.#.###########..#.....#.#.#.####
#.....!.#......#....#.#.#.#.#.#.###.#.#.#.........##.#...........#.#...........##.#####...#.#...##
#.###...########.##.#.#.#.########..#...#.##.##.#.#####.#.#.##.###.###.####.##.##.......###.######
#.#.###.#.#.......#.#.#.#.##.#.#.#.##.###.#...#.#..#.#..#.#.##.........#.....#..###.#.#.#.......##
#.#.#.#.#.#.#####.###.#.#........#.##.#...##.##.##.....##.#..#.##########.#.###.##..#.####.!.##..#
#.#.......#.#.#.#.#.#.#.##.####.##.#..#.#.#......#.#.#.####.#####.......###.###..######......##.##
#.####.#.##...#...#.#.#.##...##.#..##.######.###########.....##...##.##..##...##........##.#.#..##
#......#....#######...#.#..#..####.....##.##.##.....#.#..#.###..###...##..###..######.###..#.##.##
#############.....#####.##.#####.#.###.....#..###.#.....##.##..##.#######..###.#.#.##.######..#.##
##............###........#.......#.#.#.###.##..#..#####.####..##..#....###............##..##.##.##
##.#.#.###.##.#.###.####.#.#######...#..##.###.##.....#......###.##.##.#.##.#####.###.#....#.#####
#..#.###.#.####.#.#.#.##.#.#.....#.!.#.##....#..####.##.##.#.##.....##....#........####.##.#....##
##.#.....................#.#####.#...#.###.#.##...##.....#.#..#.#.#..##.#.#.######......#..##.#.##
##.###################.###.....#.#####...#.#..###..#####.#.##.#.####.##.#.#.....##########.##.#.##
#......................#.#.###.#.##.##.#.#.#.##.##..#.#..#.#.....##..#..#.#.#.#...............#..#
########################.#.#.###.......#.#.#.....##...##.#######..#######.#.#################.#.##
#.....#..........................#.##.##.#.###.#..#.!.##.......##.......#...#.................#.##
#.#####.#################.####.#.#######.#...#.#.##....###.#.######.#####.#.##.#####.########.#.##
#.#.....#........#.....#..#....#.#.#.....##.##....####...###..#.#.#.#.....#..#.#............#.#.##
#.##.####.########.##.##.###.###.#...######..#.##.#..###...##.....#########.##.#.###.####.#.#...##
#.##.####........####.##.#...#...##.###.#.#.##.##.#.##.###..#####..#.....#..#..#.#.####.#####.#..#
#.##......######..#......#.###.######...#.#.##..#.......##.....#########...###.#..............#.##
#.#..######....#.##.######.#...#....#.#.#.#..##.#####.#.##.#.#....#......#.....#.##############.##
#.##.#......##.#.##.##.....#.###.##...#...##..#...#.#.#..#.#.##.###.##.#.###.###..............#.##
#..#.#########.#.#..#..!.#.#.#......#.#.#.##.####.#.#.#.##.######.####.###.#.#.####.#########.#.##
##.#.....#.#...####.##...#.#...####.#.#.#..#.#..#...#.#.##.....#..#.#....#.....#.#...#......#.#.##
##.#####.#.#####..#.######.######...#.#.#.##.##.#.#...#..#.###.#.##.#.##.#.###.#.#.#.#.####.#.#.##
##.#.....#...#.#.##.#......#....#.#.#...#..#..#.#.###.####.#####.#..#.#..#.#.#.#.#.#...#..#.#.#.##
##.##.#.##.#.#.#....#.##.###.!.####.#.#.##.##.#.....#.#..#.#...#.##.#.##.#.#.#.#.#.###.#.##.#.#.##
##..#.######.#.######.####.#...#....#.#.##..#.##.##.#...##.#.!......#..#.#.....#...#.#.#....#.#.##
##.##........#........#....###.##.#...#.#..##.#####.#.#.#..#...#.##.#.##.#.#.#.#.#.#...######.#.##
##.#..########.######.#.##...#..#.#.###.#####.....#.###.##.#####.##.#.#..#.#.#.#.#.#.#........#.##
##.##..........#...#..#.####.#.##.#..#........#.#.###....#.###.#..#.#.##.#.###.#.#.############..#
##.##.#######.####.#.##.#.##.#.#..#.##.##.#.#.###.#...#.##.......##..............#...#...........#
##..###.....#.#....#.#..#....#.##.#.#...#.#.#...#.#.###..#.###.#.##########.##.#####.#.###########
##.##.##.##.#.#.####.##.####.#.##.#.#.!.#.#.###.#...#...########.....#.##.#######....#..........##
##..#..#.#..#.#......#..#.##.#....#.#...#.#.#...#.#.#.#.#...#.##.#.###....#.......##.##########.##
##.##.##.#.##.######.##.#.#..#.##.#.#####.#.#.#.#.#.#.#.#.#......###...####.#####.##.##..........#
##..#....#.#......##.#....##.#.##.#.#...#.#.###.#####.#...#.#######..#.#....#..##.......###.######
########.#.##.#.#..#.#.##.#..#.#..#.#.!.#.#.........#.#.#.#.........##.#.#####..#########........#
#........#....####.#.#######.#.##.#.....#.#.#######.#.#.#...####.####........##...........########
##.#.############..#..#......#.##.#.##.##.###...#...#.#.###.#.##.#....##.!.#..#############......#
##.###..........##.##.#.######..#.######....#.#.#.#.#.#........#.#.##.##...##....#..........######
##.#...########..###..#..#.#.#.##.....#####.#.#.###...####.###...#.##..##.###.####.###########...#
##.##.###.....##..##.##.##.#.#.##.###...#.#.#.#...#.###....#.###.#.######.#.#.#....#...........#.#
##..#.##..###.###.####.....#.#.....#..#...#.#.##.##..##.#.##.#...#.#......#.#.#.####.###########.#
##.##..##.#.###.#...##.#.#.#.#.###.#.######.#..#..#.##..#.#....###.#.######.#.#.#....#.........#.#
##.###.#..........#..#.#####.###.#.....#....#.###....######.##.##..#.#........#.######.#######...#
#..#.#.##.#.#.######.#...#.........#.!.#.##.....###.##..........#.##.#.###########...#.#.#.....###
##.....#..#.#...##.#.#.#.####.#.####...#####.##.#.#..##.##.####.#.#..#.#...........!.#.#.###.#.#.#
##.###.##.#####....#.#.#.##.#####.######...####.#.#.######.#..#.#.#.####.###.###.#...#.#.....#.#.#
##...#.##.....#.####.#.#...........##.#..#....#...#.#......#.##.#.#........###.#.#############...#
##.#.#..##.!.##.##.#.#.#############....#####.###.#.######.#..###.####.###.....#...............#.#
##.#.##.#....##.#..#.#...............#.##...#.#.#.......##.#.##...##.#.#.#.###.########.########.#
##.####.######..##.#.##############.##.#..#.#.#.##.#.##.#..#....#....#.#.#...#.......#.........#.#
##.#.#....#.##.##..#.........#......#..#.##.#.#..#.####.##.#########.###.#########.######.######.#
##.#.##.#......#..##.##.#.#########.##.#.####.#.##....#.##.#.##....#.#...#..........#.........#..#
##.#..#.####.###.##..#..#..#...##...##.#..#...#....####..#......##.#.#.###.#.################.####
##.##.####.###.#.##.###.####.###..#..#.#.##.######.##.#.##########.#.#.#...###.#.#...............#
##.#..............#.#....#...##..##.##.#..#.#..##..#..#.#............###.!.##....#.########.######
##.###.#.####.###.#.######.!.#..##..#..##.#.##..##.##.########.#.###.#.#....#.####.#.#..........##
##..##.###.##.###.#............##..###..#.#.###..#..#.##...#.#.###.#.#.##.###.##...#.#.#.#.##.#.##
###...............#.############..##...##.#...#.###....###.#.###.#.#.#.##.....#..###.#.#####..#.##
##..#.##.##.##.##.#.#............##..#.#..###.#..#####.#.#.###.#.#.###....###.##.##..#.#...####.##
##.###########.####.#########.#####.##.##...#.##..##...#.#..........###.#.#.#..#..#.##.#.!......##
#.......................................###.#..##.#..#.#.########.#.#.#.#.#.#.###.#....#...##.####
#######################################...#.##.##.####.#.......##.#.#.#.#.#.#...#.######.####....#
#######################################.#.#..#.........#.###.#.#..#...#.#.#.#.###.#......#....#.##
##.####.###.#.....#....#.###.#..###..##.#.##.######.##.#...#.###.####.#.#.#.#..#..#.##############
##.####.###.#.###.#.####.###.#.#.#.#.##.#......#.#...#####.#.###.#.##.#.#.#.#.##.##.#........#.###
##.####..#..#.#####.####.###.#.##.##.##.###.##.#.#.!.#...#.#.#...#....#.#.#.#.##.#..#.#.##.#....##
##.#####...##.#####...##.###.#.#####.##.#.#.##.......#.#...#.#.!.#.##.#.#.#.#....#.##.###..####..#
##.######.###.#####.####.###.#.#####.##.#.#.######.#...##.##.#...#.##.#.#.#.#.##.#..#.....##....##
##.######.###.###.#.####..#..#.#####.##.#.#......#.#########.##.##..#.#.#...#.#..#.##.######.##.##
##....###.###.....#....##...##.#####.##.#...####.#...........##.###.#.###.###.##.............#...#
#######################################...###....###.###.###..#.....#.....#....#.#############...#
###############################################################################################*##