##################################################################################################
#.....#.....#######.#......##.....####......................................................#.##.#
#.....#####.#.#...#.#.##.#####.##.#..###....................................................#....#
#..@............!.#.#.#...#..#.#..##...#...#####...#...#####.#...#...#.....#...#..#...#.....#.!.##
#.....#####.###...#.#.#.!.#.##.##.##.#.....#...#..###..#...#.##.##..###...###..#..#..###....#...##
#.....#..##.#.#####.#.#...#.##.##.#..###...#...#..#.#..#......###...#.#...#.#..#.##..#.#....##.###
###.####.......#....#.#####.#...#.##..#....#...#..#.#..#.......#....#.#...#.#..###...#.#.......###
#...#..#.#####.#.####.......#####.#..###...#...#.#####.#......###..#####.##.##.#.##.#####...##..##
#.#.#.##.#...#.#.##.#.##.#.##...#.##.#.....#...#.#...#.#...#.##.##.#...#.#...#.#..#.#...#...##.###
#.#.#.##.#.!...........#.#....#........#...#...#.#...#.#####.#...#.#...#.#...#.#..#.#...#...#..###
#.#.#.#..#...#.###.###.#.##.#####.######....................................................##..##
###.#.##.#####.#.###.###..#.#.....#.#..#....................................................#..###
#..............#.........##.##.####.#.########################################################.###
#.#.############.#####.###...#.#................................................................##
#.#.#..........#.#...###.###.#.##.#.#####.#####.#########.###.####.#.##########################.##
#.#.#.########.#.#.#.....#.#.####.###...#.....#.##......###.#....###.#..............#.........#.##
#.#.#....#...#.#.###.###.#.#........##.##.###.#....##.#.......##.#.#.#.#.#.##.##.!.##.##.#.##.#.##
#.#.##.#.#.###.#.#.#.#.#.#.#.######.#.....#...#.##.########.####.#.#.#.#####...#...#...#.######..#
#.#.####.#.#...#.....#...#...#....#...#######.#.####.##.##...#...#.#.#.....##.####.##.##........##
#........#.#.#########.#.##.###.#.#.#.#.##.##.#...#......###.#.#.#.#.#######....##....#..##.##.###
###.######...#...#.....#..###.###.#.#.#.......#.#.##.#.#..#..###.#.#.#.......##..##########.#..###
###.#...######.#.####.###.........#.#.#.#########....#########.#.#.#.###########..#.....#.#.#.####
#.....!.#......#....#.#.#.#.#.#.###.#.#.#.........##.#...........#.#...........##.#####...#.#...##
#.###...########.##.#.#.#.########..#...#.##.##.#.#####.#.#.##.###.###.####.##.##.......###.######
#.#.###.#.#.......#.#.#.#.##.#.#.#.##.###.#...#.#..#.#..#.#.##.........#.....#..###.#.#.#.......##
#.#.#.#.#.#.#####.###.#.#........#.##.#...###.##.##.....##.#..#.#########.#.###.##..#.####.!.##..#