////////////////////////////////////////////////////////////////////////////////////////////////////
/##################################################################################################/
/#.....#.....#######.#......##.....####......................................................#.##.#/
/#.....#####.#.#...#.#.##.#####.##.#..###....................................................#....#/
/#..@............!.#.#.#...#..#.#..##...#...#####...#...#####.#...#...#.....#...#..#....#....#.!.##/
/#.....#####.###...#.#.#.!.#.##.##.##.#.....#...#..###..#...#.##.##..###...###..#..#...###...#...##/
/#.....#..##.#.#####.#.#...#.##.##.#..###...#...#..#.#..#......###...#.#...#.#..#.##...#.#...##.###/
/###.####.......#....#.#####.#...#.##..#....#...#..#.#..#.......#....#.#...#.#..###....#.#......###/
/#...#..#.#####.#.####.......#####.#..###...#...#.#####.#......###..#####.##.##.#.##..#####..##..##/
/#.#.#.##.#...#.#.##.#.##.#.##...#.##.#.....#...#.#...#.#...#.##.##.#...#.#...#.#..#..#...#..##.###/
/#.#.#.##.#.!...........#.#....#........#...#...#.#...#.#####.#...#.#...#.#...#.#..#..#...#..#..###/
/#.#.#.#..#...#.###.###.#.##.#####.######....................................................##..##/
/###.#.##.#####.#.###.###..#.#.....#.#..#....................................................#..###/
/#..............#.........##.##.####.#.########################################################.###/
/#.#.############.#####.###...#.#................................................................##/
/#.#.#..........#.#...###.###.#.##.#.#####.#####.#########.###.####.#.##########################.##/
/#.#.#.########.#.#.#.....#.#.####.###...#.....#.##......###.#....###.#..............#.........#.##/
/#.#.#....#...#.#.###.###.#.#........##.##.###.#....##.#.......##.#.#.#.#.#.##.##.!.##.##.#.##.#.##/
/#.#.##.#.#.###.#.#.#.#.#.#.#.######.#.....#...#.##.########.####.#.#.#.#####...#...#...#.######..#/
/#.#.####.#.#...#.....#...#...#....#...#######.#.####.##.##...#...#.#.#.....##.####.##.##........##/
/#........#.#.#########.#.##.###.#.#.#.#.##.##.#...#......###.#.#.#.#.#######....##....#..##.##.###/
/###.######...#...#.....#..###.###.#.#.#.......#.#.##.#.#..#..###.#.#.#.......##..##########.#..###/
/###.#...######.#.####.###.........#.#.#.#########....#########.#.#.#.###########..#.....#.#.#.####/
/#.....!.#......#....#.#.#.#.#.#.###.#.#.#.........##.#...........#.#...........##.#####...#.#...##/
/#.###...########.##.#.#.#.########..#...#.##.##.#.#####.#.#.##.###.###.####.##.##.......###.######/
/#.#.###.#.#.......#.#.#.#.##.#.#.#.##.###.#...#.#..#.#..#.#.##.........#.....#..###.#.#.#.......##/
/#.#.#.#.#.#.#####.###.#.#........#.##.#...##.##.##.....##.#..#.##########.#.###.##..#.####.!.##..#/
/#.#.......#.#.#.#.#.#.#.##.####.##.#..#.#.#......#.#.#.####.#####.......###.###..######......##.##/
/#.####.#.##...#...#.#.#.##...##.#..##.######.###########.....##...##.##..##...##........##.#.#..##/
/#......#....#######...#.#..#..####.....##.##.##.....#.#..#.###..###...##..###..######.###..#.##.##/
/#############.....#####.##.#####.#.###.....#..###.#.....##.##..##.#######..###.#.#.##.######..#.##/
/##............###........#.......#.#.#.###.##..#..#####.####..##..#....###............##..##.##.##/
/##.#.#.###.##.#.###.####.#.#######...#..##.###.##.....#......###.##.##.#.##.#####.###.#....#.#####/
/#..#.###.#.####.#.#.#.##.#.#.....#.!.#.##....#..####.##.##.#.##.....##....#........####.##.#....##/
/##.#.....................#.#####.#...#.###.#.##...##.....#.#..#.#.#..##.#.#.######......#..##.#.##/
/##.###################.###.....#.#####...#.#..###..#####.#.##.#.####.##.#.#.....##########.##.#.##/
/#......................#.#.###.#.##.##.#.#.#.##.##..#.#..#.#.....##..#..#.#.#.#...............#..#/
/########################.#.#.###.......#.#.#.....##...##.#######..#######.#.#################.#.##/
/#.....#..........................#.##.##.#.###.#..#.!.##.......##.......#...#.................#.##/
/#.#####.#################.####.#.#######.#...#.#.##....###.#.######.#####.#.##.#####.########.#.##/
/#.#.....#........#.....#..#....#.#.#.....##.##....####...###..#.#.#.#.....#..#.#............#.#.##/
/#.##.####.########.##.##.###.###.#...######..#.##.#..###...##.....#########.##.#.###.####.#.#...##/
/#.##.####........####.##.#...#...##.###.#.#.##.##.#.##.###..#####..#.....#..#..#.#.####.#####.#..#/
/#.##......######..#......#.###.######...#.#.##..#.......##.....#########...###.#..............#.##/
/#.#..######....#.##.######.#...#....#.#.#.#..##.#####.#.##.#.#....#......#.....#.##############.##/
/#.##.#......##.#.##.##.....#.###.##...#...##..#...#.#.#..#.#.##.###.##.#.###.###..............#.##/
/#..#.#########.#.#..#..!.#.#.#......#.#.#.##.####.#.#.#.##.######.####.###.#.#.####.#########.#.##/
/##.#.....#.#...####.##...#.#...####.#.#.#..#.#..#...#.#.##.....#..#.#....#.....#.#...#......#.#.##/
/##.#####.#.#####..#.######.######...#.#.#.##.##.#.#...#..#.###.#.##.#.##.#.###.#.#.#.#.####.#.#.##/
/##.#.....#...#.#.##.#......#....#.#.#...#..#..#.#.###.####.#####.#..#.#..#.#.#.#.#.#...#..#.#.#.##/
/##.##.#.##.#.#.#....#.##.###.!.####.#.#.##.##.#.....#.#..#.#...#.##.#.##.#.#.#.#.#.###.#.##.#.#.##/
/##..#.######.#.######.####.#...#....#.#.##..#.##.##.#...##.#.!......#..#.#.....#...#.#.#....#.#.##/
/##.##........#........#....###.##.#...#.#..##.#####.#.#.#..#...#.##.#.##.#.#.#.#.#.#...######.#.##/
/##.#..########.######.#.##...#..#.#.###.#####.....#.###.##.#####.##.#.#..#.#.#.#.#.#.#........#.##/
/##.##..........#...#..#.####.#.##.#..#........#.#.###....#.###.#..#.#.##.#.###.#.#.############..#/
/##.##.#######.####.#.##.#.##.#.#..#.##.##.#.#.###.#...#.##.......##..............#...#...........#/
/##..###.....#.#....#.#..#....#.##.#.#...#.#.#...#.#.###..#.###.#.##########.##.#####.#.###########/
/##.##.##.##.#.#.####.##.####.#.##.#.#.!.#.#.###.#...#...########.....#.##.#######....#..........##/
/##..#..#.#..#.#......#..#.##.#....#.#...#.#.#...#.#.#.#.#...#.##.#.###....#.......##.##########.##/
/##.##.##.#.##.######.##.#.#..#.##.#.#####.#.#.#.#.#.#.#.#.#......###...####.#####.##.##..........#/
/##..#....#.#......##.#....##.#.##.#.#...#.#.###.#####.#...#.#######..#.#....#..##.......###.######/
/########.#.##.#.#..#.#.##.#..#.#..#.#.!.#.#.........#.#.#.#.........##.#.#####..#########........#/
/#........#....####.#.#######.#.##.#.....#.#.#######.#.#.#...####.####........##...........########/
/##.#.############..#..#......#.##.#.##.##.###...#...#.#.###.#.##.#....##.!.#..#############......#/
/##.###..........##.##.#.######..#.######....#.#.#.#.#.#........#.#.##.##...##....#..........######/
/##.#...########..###..#..#.#.#.##.....#####.#.#.###...####.###...#.##..##.###.####.###########...#/
/##.##.###.....##..##.##.##.#.#.##.###...#.#.#.#...#.###....#.###.#.######.#.#.#....#...........#.#/
/##..#.##..###.###.####.....#.#.....#..#...#.#.##.##..##.#.##.#...#.#......#.#.#.####.###########.#/
/##.##..##.#.###.#...##.#.#.#.#.###.#.######.#..#..#.##..#.#....###.#.######.#.#.#....#.........#.#/
/##.###.#..........#..#.#####.###.#.....#....#.###....######.##.##..#.#........#.######.#######...#/
/#..#.#.##.#.#.######.#...#.........#.!.#.##.....###.##..........#.##.#.###########...#.#.#.....###/
/##.....#..#.#...##.#.#.#.####.#.####...#####.##.#.#..##.##.####.#.#..#.#...........!.#.#.###.#.#.#/
/##.###.##.#####....#.#.#.##.#####.######...####.#.#.######.#..#.#.#.####.###.###.#...#.#.....#.#.#/
/##...#.##.....#.####.#.#...........##.#..#....#...#.#......#.##.#.#........###.#.#############...#/
/##.#.#..##.!.##.##.#.#.#############....#####.###.#.######.#..###.####.###.....#...............#.#/
/##.#.##.#....##.#..#.#...............#.##...#.#.#.......##.#.##...##.#.#.#.###.########.########.#/
/##.####.######..##.#.##############.##.#..#.#.#.##.#.##.#..#....#....#.#.#...#.......#.........#.#/
/##.#.#....#.##.##..#.........#......#..#.##.#.#..#.####.##.#########.###.#########.######.######.#/
/##.#.##.#......#..##.##.#.#########.##.#.####.#.##....#.##.#.##....#.#...#..........#.........#..#/
/##.#..#.####.###.##..#..#..#...##...##.#..#...#....####..#......##.#.#.###.#.################.####/
/##.##.####.###.#.##.###.####.###..#..#.#.##.######.##.#.##########.#.#.#...###.#.#...............#/
/##.#..............#.#....#...##..##.##.#..#.#..##..#..#.#............###.!.##....#.########.######/
/##.###.#.####.###.#.######.!.#..##..#..##.#.##..##.##.########.#.###.#.#....#.####.#.#..........##/
/##..##.###.##.###.#............##..###..#.#.###..#..#.##...#.#.###.#.#.##.###.##...#.#.#.#.##.#.##/
/###...............#.############..##...##.#...#.###....###.#.###.#.#.#.##.....#..###.#.#####..#.##/
/##..#.##.##.##.##.#.#............##..#.#..###.#..#####.#.#.###.#.#.###....###.##.##..#.#...####.##/
/##.###########.####.#########.#####.##.##...#.##..##...#.#..........###.#.#.#..#..#.##.#.!......##/
/#.......................................###.#..##.#..#.#.########.#.#.#.#.#.#.###.#....#...##.####/
/#######################################...#.##.##.####.#.......##.#.#.#.#.#.#...#.######.####....#/
/#######################################.#.#..#.........#.###.#.#..#...#.#.#.#.###.#......#....#.##/
/##.####.###.#.....#....#.###.#..###..##.#.##.######.##.#...#.###.####.#.#.#.#..#..#.##############/
/##.####.###.#.###.#.####.###.#.#.#.#.##.#......#.#...#####.#.###.#.##.#.#.#.#.##.##.#........#.###/
/##.####..#..#.#####.####.###.#.##.##.##.###.##.#.#.!.#...#.#.#...#....#.#.#.#.##.#..#.#.##.#....##/
/##.#####...##.#####...##.###.#.#####.##.#.#.##.......#.#...#.#.!.#.##.#.#.#.#....#.##.###..####..#/
/##.######.###.#####.####.###.#.#####.##.#.#.######.#...##.##.#...#.##.#.#.#.#.##.#..#.....##....##/
/##.######.###.###.#.####..#..#.#####.##.#.#......#.#########.##.##..#.#.#...#.#..#.##.######.##.##/
/##....###.###.....#....##...##.#####.##.#...####.#...........##.###.#.###.###.##.............#...#/
/#######################################...###....###.###.###..#.....#.....#....#.#############...#/
/###############################################################################################*##/
////////////////////////////////////////////////////////////////////////////////////////////////////